name Nonsquare Dungeon of Disaster
win 4
      ##########
      #........#
#######........#
 #..............#
  #..............#
   #######........#
      #........##########
      #.................#
#######................#
#.....................#
#######..#####.......#
      #..#   #......#
      ####   #######